
  ### ########  ##  #      #
   #####     #  #  ##      #
   # ##  ######################
    ##   #  #      ##         #
   # #  #  #########         ####
   #  ### ###
   ####     ####
   #                   #####
   #                       #
   #  #########      #     #
   # ##     #        #########
   ######   #        #
            ##########
            #      #
            #      ##
