                                  
 #    ##       #
 ######      ###
 # # # # ##   #
 ###   ########
   #####
       #########
   #####
      #     ####
     ## #  ##
      ##########
