                                         
 ### ### #######
 # # # # # # # #
 ## ## ## ## ##
  ###  ###  ###
  #           #
 ##  ## # #   ##
  #############
