
    ##
    #
  ###    #
    ######    #
    ##        #     #
    #################
  ###            #
    #
