
    ########     #
    #  # # ####  #
    #### # ####  #
    #  ### #     #
    #    ######  #
    #########    #
  ###   #   ######
    #   #   #
