
  ##############
     #   #       #
     #   ######  #
     #   #    #  #
   ###   ###  #  #
     ##  #    #  #
      ##  #####  #
      #      #   #
  ################
