
    #                  #        
    #             ###########
  ############    #         #
        #         #       # #
        #     #####       # #
        #     #   #       # #
        #         #       # #
   $###############       # #
        #        ########## #
        #        ##       # #
        #        ##       # #
        #                 # #
        #                 # #
        #   #             # #
        #   #     ######### #
       ######    # #     # ##
        #   #    ####    # #
        ##############    ###
