
    #   #   # 
    #   #   #
  ############
    #    #
    #####
    #
    #
