
  ##### ### #####
    # # #   #
  ### ####### # #
  #   #   #   # #
  ### # #########
  # # # #       #
  # # # ### ### #
  #   #   # #
  ### ### # #####
  #   #   # #
  ### ### ### ###
    # #   # # # #
  ### # ### ### #
  #         #
  ### ###########
