

  ##### #######
  ## ## ###  ##
  ####### ####
  #############
  ##  ### ####
  # ## ###### #
  ### # #######
  # ### #  ## #
  #  ##### ####
