                         
    ######  ########
      #######  #
       #      #####
     ######      #
      #  #      ###
      #  #      # #
      #############
         #       #######
         #            #
     ##############   #
      #        #   ####
      #  ####  #    #
      #####    ######
        #        #
        #####    #
          #      ##
