
  #####################
  #         #         #
  #         #         #
  #         #         #
  #         #         #
  #         #         #
  #         #         #
  #         #         #
  #         #         #
  #                   #
  ######### # #########  
  #                   #
  #         #         #
  #         #         #
  #         #         #
  #         #         #
  #         #         #
  #         #         #
  #         #         #
  #         #         #
  #####################
