
 ##############################
 #                        #
 #         ################
 #         #
 #         ###########
 ###########         #
       #             ########
       #             #
       ###############
            #
            #
            #
