
 #
 #######
 #            #####################
 #                  ###        #
 #######       #    #          #
      #        ###########     #
      #        #       #       #
      ##########       #       #
          #            #########
          #            #
          ##############
  ###    ###       #
   ########        #         #
   #            #####################
   #                  ###        #
   #######       #    #          #
        #        ###########     #
        #        #       #       #
        ##########       #       #
            #            #########
            #            #
            ###############
    ##########
      ###
