    
    ##################################
    #########                  #######
    ######      ######## # ####    ###
    ################### ##############
    ##########     #### #####     ####
    ##         #####    ## ###########
    ######   ############   ##########
    #################  #####  ########
    #######      #####################
    #######              ######
    ###############       ############
    ##   #### ####           ###   ###
    ##### #####  ################   ##
    ########      #####   ########
    ############# ######          ####
