
    #       #### ##
  ###   #          #
    #####     ######
  ###            ##
  # ######       # #
  ##   ## #     #
  #         #  # ##
 ######## ##########
  ## #    #    ##  #
  #         #     ##
  ##
