
  #######  ##    #      ###
  #         ######## #    #
  ###         ## # #####
    #   #######     ##   ##
  #######    #########
    # # #     ##  ## #
  ###  ##      ######
    #   #####    ## ### #
  # ##   ##           ####
  #      ####        ## # #
  #         ##        ###
  #         ###### #  ###
  #       ##            ####
  #####   ##   ###   ##  #
  #     ###       ##    ##
  # #############        ##
        #######     ########
