                        
 #   ###################
 #   #                 #
 #########             ############
    #    # ##                             #
    #########          #        #####     #
    #     ########             ##   #  ####
    ##########   #     #### ######  #   ###
            #          ###  #    #  #    ##
            #          ##   #    ##########
            ##################        ##
            #        ####     #########
