         #
  ########  #
         #  #
         #  #
      #######
   ####
      #
  ######
  #
  #
 #############
         #
         #####
  ########   #
     #       #
     #       #
