###########################################
###########################################
###################         ######
#######
#            		                                                        ################
#                                                                       #
##########################################################################
#                                                  ###################
