          
 #   #    # #
 #  ###   #####
 #### #####
   #    #
  ##   ##
